


1111111111111111111111111111111111
1000000000000000010000000000000001
10P0000000000000010000000000000001
1000000000000000010000000000000001
1000000000000000010000000000000001
1000000000000001000000000000000001
1000000000000000000000000000000001
1111100000000010011110000001111111
    10000000000001  10000001
    100000000000011110000001
    100000000000000000000001
    100000000000000000000001
1111100000000000000000000001111111
1000000000000000000000000000000001
1000000000000000000000000000000001
1000000000000000000000000000000001
1000000000000000000000000000000001
1000000000000000000000000000000001
1000000000000000000000000000000001
1000000000000000000111111100000001
10000000000000000001     100000001
11100000000000000001      10000001
   10000000000000001      10000001
   11111111111111111      11111111
