1111111111111111111111111111111111
1000000000000000000000000000000001
10P0000000000000000000000000000001
1000000000000000000000000000000001
1000000000000000000000000000000001
1000000000000000000000000000000001
1000000000000000000000000000000001
1111100000000000000000000001111111
    100000000000000000000001
    100000000000000000000001
    100000000000000000000001
    100000000000000000000001
1111100000000000000000000001111111
1000000000000000000000000000000001
1000000000000000000000000000000001
1000000000000000000000000000000001
1000000000000000000000000000000001
1000000000000000000000000000000001
1000000000000000000000000000000001
1000000000000000000000000000000001
1000000000000000000000000000000001
1000000000000000000000000000000001
1000000000000000000000000000000001
1111111111111111111111111111111111
